0000000000000000000000000000000000000000000000000
0000000000000000000000000000000000000000000000000
0000000000000000000000000000000000000000000000000
0000000000000000000000000000000000000000000000000
0000000000000000000000000000000000000000000000000
00000000070000000000000000000000000000000000v0000
00000000000000000000000000000000000000000000f0000
000000000000000000000000000000000000000i0000f0000
000000000g0000000000000222000000000000000000f0000
00000007e6e6000000000000000000000000000h0000f0000
000000000000000000000000000000000000040h0000f0000
000000000000000000000000000000000000040h0000f0000
00000m00000000000g00000000000q000000040h0000f0000
11111111111111111111111b00000p00000a1111111111111
33333333333333333333333d00000p00000c3333333333333
33333333333333333333333d00000p00000c3333333333333
33333333333333333333333d00000p00000c3333333333333
