000000000000000000000p00000000p000000p000000000000000000000
000000000000000000000p00000000p000000p000000000000000000000
000000000000000000000p00000000p000000t000000000000000000000
000000000000000000000t00000000t0000000000000000000000000000
000000000000000000000000000000000000000000000000000000v0000
000000002200000000000000000000000000000000000000000000f0000
000000000000000000000000000000000000000000000000000i00f0000
000000000000000000000000000000000000000000000000000000f0000
0000000000000000000000000q00000000t00000q0000000000h00f0000
0000000400400000000t00000p00000000p00000p0000000000h00f0000
0000000400400000000p00000p0000t000p00000p00000t0000h00f0000
00m00004s040g000000p00000p0000p000p00000p00000p0000h00f0000
1111111111111111b00p00000p0000p000p00000p00000p000111111111
3333333333333333d00p00000p0000p000p00000p00000p000333333333
3333333333333333d00p00000p0000p000p00000p00000p000333333333
3333333333333333d00p00000p0000p000p00000p00000p000333333333
