000000000000000000000000000000000000000000000000
000000000000000000000000000000000000000000000000
000000000000000000000000000000000000000000000000
000000000000000000000000000000000000000000000000
000000000000000000000000000000000000000000000000
0000000000000000000000000000000000000000000v0000
0000000000000000000000000000000000000000000f0000
0000000000000000000000000000000000000000000f0000
0000000000000000000t00000000000000000000000f0000
000000000g000000000p00eee7e0000000000000000f0000
00000000000eee67000p0000000000000000t000000f0000
0000000000000000000p0000000000000000p000000f0000
g0000m000000g000000p00000g00000g0000p000000f0000
111111111111111111111111111111111111111111111111
333333333333333333333333333333333333333333333333
333333333333333333333333333333333333333333333333
333333333333333333333333333333333333333333333333
