0000000000000000000000000000000000000000000000000
0000000000000000000000000000000000000000000000000
0000000000000000000000000000000000000000000000000
0000000000000000000000000000000000000000000000000
0000000000000000000000000000000000000000000000000
0000000000000000000200000000000000000000000v00000
0000000000000000000000000000000000000000000f00000
0000000000002220000l00000000000000000000000f00000
0000000000000000000t000l0000000000000000000f00000
0000000000000g00000p000ee7e0000000000000000f00000
00000000000eee67000p0000000000000000q000000f00000
0000000000000000000p0000000000000000p000000f00000
g0000m000000g000000p00000g00000g0000p000000f00000
1111111111111111111111111111111111111111111111111
3333333333333333333333333333333333333333333333333
3333333333333333333333333333333333333333333333333
3333333333333333333333333333333333333333333333333
