0000000000000000000000000000000000000000000000000
0000000000000000000000000000000000000000000000000
0000000000000000000000000000000000000000000000000
0000000000000000000000000000000000000000000000000
000v000000000000000000000000000000000000000000000
000f000000000000000200000000000000000000000000000
000f000000000000000000000000000000000000000000000
000f0000q0002220000l0000000000000000q000000000000
000f0000p0000000000t000000000k000000p000000000000
000f0000p0000g00000p0004400ee7e00000p000000000000
000f0000p00eee67000p0000000000000000p004000000000
000f0000p0000000000p0000000000000000p000000000000
000f0000p00g0000000p00000g00000g0000p000000m00000
1111111111111111111111111111111111111111111111111
3333333333333333333333333333333333333333333333333
3333333333333333333333333333333333333333333333333
3333333333333333333333333333333333333333333333333
