00000000000000000000000000000000000000000000000000000000000000000000000000000000000000000000000000000000000000
00000000000000000000000000000000000000000000000000000000000000000000000000000000000000000000000000000000000000
00000000000000000000000000000000000000000000000000000000000000000000000000000000000000000000000000000000000000
00000000000000000000000000000000000000000220000000000000000000000000000000000000000000000000000000000000000000
0000000000000000000000000000000000000000000000000000000000000000000000000000000022000000000000000000000000v000
00000000000000000000000000000000000000000000000000000000g0000000000000000000000000000000000000000000000000f000
0000000000000000022000000000000000000006eee600000000geeeeeeee000000t00000000000000000000000000000000000000f000
0000000000000000000000000000000000000000000000000000000000000000000p00000000000000000000000000000000000000f000
000000000000000000000000000000000000000000000000000eeee000000000000p00000000000666000000000000000000000000f000
0000000000000000ee7e000000t000000000006e6e6e60000000000000000000000p00000000000000000000000000000000000000f000
00000000000000000000000000p0000000000000000000000000000000000000000p00000000000000000000000000000000000000f000
00000000000000000000000000p0000000000000000000000000000000000000000p00000000000000000000000000000000000000f000
0m000000000l00000000000000p000000000g00000g000g0000000l000000000000p00000000000000000000000000000000000000f000
11111111111111111111111111111111111111111111111111111111111111111111111111111111111111111111111111111111111111
33333333333333333333333333333333333333333333333333333333333333333333333333333333333333333333333333333333333333
33333333333333333333333333333333333333333333333333333333333333333333333333333333333333333333333333333333333333
33333333333333333333333333333333333333333333333333333333333333333333333333333333333333333333333333333333333333
