0000000000000000000000000000000000000000000000000
0000000000000000000000000000000000000000000000000
0000000000000000000000000000000000000000000000000
0000000000000000000000000000000000000000000000000
0000000000000000000000000000000000000000000000000
00000000070000000000000000000000000000000000v0000
00000000000000000000000000000000000000000000f0000
00000000000000000000000000000000000000000000f0000
000000000g0000000000000222000000000000020000f0000
00000007e6e600000000000000000l00000000020000f0000
000000000000000000000000000a1111b00000020000f0000
000000000000000000000000000c3333d00000000400f0000
00000m00000000000g000000000c3333d0000000g400f0000
111111111111111111111b00000c3333d0000a11111111111
333333333333333333333d00000c3333d0000c33333333333
333333333333333333333d00000c3333d0000c33333333333
333333333333333333333d00000c3333d0000c33333333333
