00000000000000000000000000000000000000000000000000000000000000000000000000000000000000000000000000000000000000000000
00000000000000000000000000000000000000000000000000000000000000000000000000000200000000000000000000000000000000000000
00000000000000000000000000000000000000000000000000002000000000000000000000000000000000000000000000000000000000000000
00000000000000000000000000000000000000000000000000000000000000000000000000000000000000000000000000000000000000000000
000000000000000000000000000000000000000000000000000000000000000000000700000eee0000000000000000000000000000000000v000
00000000000000000000000000000000000000000000000000eee00000000000000000000000000000000000000000000000000000000000f000
0000000000000000000000000000000002000000000000000000000000000000000000000000000000t00000000000200000000000000000f000
0000000000000000000000000000000000000000000000000000000000000000000000ee0000000000p00000000000000000000000000000f000
0000000000000000000000000000000000000000000000000000000000040000000000000000000000p00000000000000000000000000000f000
0000000000077700000000t000000000e7e00000022200000070000040040000000700000000000000p00000000000700000000000000000f000
0000002200000000000000p00000000000000000000000000000000440040000000000000000000000p00000000000000000000000000000f000
0000000000000000000000p00000000000000000000000000000004440040000000000000000000000p00000000000000000000000000000f000
0m0000000000000g000000p000000000g00000000g000000000004444004000g00000000g000000000p00000000000000000000000000000f000
11111111111111111111111111111111111111111111111111111111b00a11111111111111111111111111111111111111111111111111111111
33333333333333333333333333333333333333333333333333333333d00c33333333333333333333333333333333333333333333333333333333
33333333333333333333333333333333333333333333333333333333d00c33333333333333333333333333333333333333333333333333333333
33333333333333333333333333333333333333333333333333333333d00c33333333333333333333333333333333333333333333333333333333
