000000000000000000000000000000000000000000000000000000000
000000000000000000200000000000000000000000000000000000000
000000000000000000000000000000000000000000000000000000000
000000000000000000000000000000000000000000000000000000000
0000000000700000eee0000000000000000000000000000000v000000
00000000000000000000000000000000000000000000000000f000000
00000000000000000000000t00000000000200000000000000f000000
00000000000440000000000p00000000000000000000000000f000000
00000000000000000000000p00000000000000000222000000f000000
00000000700000000000000p00000000000700000000000000f000000
00000000000000000000000p00000000000000000444000000f000000
00000000000000000000000p00000000000000000404000000f000000
00m00000g000000000g0000p00000k000000k0000404000000f000000
a11111111111111111111111111111111111111111111111111111111
c33333333333333333333333333333333333333333333333333333333
c33333333333333333333333333333333333333333333333333333333
c33333333333333333333333333333333333333333333333333333333
