0000000000000000000000000000000000000000000000000000000000000000000000000000000000000000000000000000000000000000000
00000000000000000000000000000000000000000000000000000000000000000000000000000000000000000000000000000000000000v0000
0000000000eeeeeeeeee000000000000000000000000000000000000000000000000000000000000000000000000000000000000000000f0000
00000000000000000000000000000000000000000000000000000000000000000000000000000000000000000000000000000000000000f0000
002200000000000000000000000000600000000000000000000000000000000000000000000000000000000022000000t0000000000000f0000
0000000t0000000000000000000000000000000000000000000000000000000000000000000004000000000000000000p0000000000000f0000
0000000p0000022000000000000000000000e7e000000000000000000000000000000000000044000000000000000000p0000000000000f0000
0000000p0000000000000400000000000000000000000000000000000000002000000000000444000000000000000000p0000000000000f0000
0000000p0000000000000400000000e00000000000000000000000000000000000000000004444000000000066000000p0000000000000f0000
0000000p0000000000000400000000000000000000000000000000000000000000000000044444000000000000000000p0000000000000f0000
0000000p0000000000000400000000000000000000000000000000000000000000000000444444000000000000000000p0000000000000f0000
0000000p0000000000000400000000000000000000000000000000000000000000000004444444000000000000000000p0000000000000f0000
00m0000p000000g00000g400000000g00000g00000000000000000000000000000000044444444000000g0000g000000p0000000000000f0000
1111111111111111111111111111111111111111111b00000000000a11111111111111111111111111111111111111111111111111111111111
3333333333333333333333333333333333333333333d00000000000c33333333333333333333333333333333333333333333333333333333333
3333333333333333333333333333333333333333333d00000000000c33333333333333333333333333333333333333333333333333333333333
3333333333333333333333333333333333333333333d00000000000c33333333333333333333333333333333333333333333333333333333333
