0000000000000000000000000000000000000000000000000
00000000000000000000000000000000000000000000v0000
0000000000ee00ee0000000000002222222222220000f0000
00000000000000000000000000002222222222220000f0000
00220000000000000000000000002222222222220000f0000
0000000q000000000q00000000002222222222220000f0000
0000000p000222200p00000000002222222222220000f0000
0000000p000000000p00000000000000000000000000f0000
0000000p000000000p00000000000000000000000000f0000
0000000p000000000p00000000000000000000000000f0000
0000000p000000000p00000000000000000000000000f0000
0000000p000000000p00000000000000000000000000f0000
00m0000p000000g00p00000000000000000000000000f0000
111111111111111111111111111b000000000000a11111111
333333333333333333333333333d000000000000c33333333
333333333333333333333333333d000000000000c33333333
333333333333333333333333333d000000000000c33333333
