00000000000000000000000000000000000000000000000000000000000000000000000000000000000000000000000000000000000000
00000000000000000000000000000000000000000000000000000000000000000000000000000000000000000000000000000000000000
00000000000000000000000000000000000000000000000000000000000000000000000000000000000000000000000000000000000000
00000000000000000000000000000000000000000000000000000000000000000000000000000000000000000000000000000000000000
00000000000000000000000000000000000000000000000000000000000000000000000000000000000000000000000000000000000000
00000000000000000000000000000000000000000000000000000000000000000000000000000000000000000000000000000000000000
0000000000000000000000000000000000000000000000000000000000000000000000000000000000000000000000000000000000v000
0000000000000000000000000000000000000000000000000000000000000000000000000000000000000000000000000000000000f000
0000000000g00000000000000000000000000000000000000000000000000000000000000000000000000000000000000000000000f000
00000000ge6e00000t0000000000000000000000000000000000000000000000000000000000000000000000000000000000000000f000
04000000000000000p0000000000000000000000000000000000000000000000000000000000000000000000000000000000000000f000
04000000000000000p0000000000000000000000000000000000000000000000000000000000000000000000000000000000000000f000
04m0000gggg00g00gp0000000000000000000000000000000000000000000000000000000000000000000000000000000000000000f000
11111111111111111111111111111111111111111111111111111111111111111111111111111111111111111111111111111111111111
33333333333333333333333333333333333333333333333333333333333333333333333333333333333333333333333333333333333333
33333333333333333333333333333333333333333333333333333333333333333333333333333333333333333333333333333333333333
33333333333333333333333333333333333333333333333333333333333333333333333333333333333333333333333333333333333333
