333333333333333333333333333d00c333333333333333333
333333333333333333333333333d00c333333333333333333
333333333333333333333333333d00c333333333333333333
111111111111111111111111111b00a111111111111111111
000000000000p000000000000000000044400g044400f0000
00m00000g000p0000000000000000000440000004400f0000
000000000000p0000000000000000000400000000400f0000
000000600000p000000eee0000000000000000000000f0000
000000000000t0000000000000000000000000000000f0000
00000000000000000000000000000000000000000000f0000
00000000000000000000000000000000000000000000v0000
0000000000000000000220000000000000000000000000000
0000000000000000000000000000000000000000000000000
0000000000000000000000000000000000000000000000000
0000000000000000000000000000000000000000000000000
0000000000000000000000000000000000000000000000000
0000000000000000000000000000000000000000000000000
