333333333333333333333333333d00c33333333333333333333333333d00c3333333333333333333333333333333333333333333333333
333333333333333333333333333d00c33333333333333333333333333d00c3333333333333333333333333333333333333333333333333
333333333333333333333333333d00c33333333333333333333333333d00c3333333333333333333333333333333333333333333333333
111111111111111111111111111b00a11111111111111111111111111b00a1111111111111111111111111111111111111111111111111
000000000000p000000000000000000000000g00g00000000000000000000000g00000g00p00g044444000000000000000000000000f00
00m00000g000p000000000000000000000000000000000000000000000000000000000000p000044440000000000000000000000000f00
000000000000p0000000000000000000000000000000eeee0000000000000000002020200p000044400000000000000000000000000f00
000000600000p000000e7e000000000000000000000000000000000000000000000000000p000044000000000600eeee00000000000f00
000000000000t000000000000000000000000000000000000000000000000000000000000t000040000000000000000000000000000f00
00000000000000000000000000000000000000000000e7e600000000000000000000000000000000000000000000000000000000000f00
00000000000000000000000000000000000000000000000000000000000000000000000000000000000000000000022000000000000v00
00000000000000000002200000000000000000000000000000000000000000000000000000000000000000000000000000000000000000
00000000000000000000000000000000000000000000000000000000000000000000000000000000000000000000000000000000000000
00000000000000000000000000000000000000000000000000000000000000000000000000000000000000000000000000000000000000
00000000000000000000000000000000000000000000000000000000000000000000000000000000000000000000000000000000000000
00000000000000000000000000000000000000000000000000000000000000000000000000000000000000000000000000000000000000
00000000000000000000000000000000000000000000000000000000000000000000000000000000000000000000000000000000000000
