0000000000000000000000000000000000000000000000000000000000000000000000000000000000000000000000000000000000000000000000000000000000000000000000000000000000000000000000000000000000000000000000000000000000000000
0000000000000000000000000000000000000000000000000000000000000000000000000000000000000000000000000000000000000000000000000000000000000000000000000000000000000000000000000000000000000000000000000000000000000000
0000000000000000000000000000000000000000000000000000000000000000000000000000000000000000000000000000000000000000000000000000000000000000000000000000000000000000000000000000000000000000000000000000000000000000
00000000000000000000000000000000000000000000000000000000000000000000000000000000000000000000000000000000000000000000000000000000000000000000000000000000000000000000000000000000000000000000000440000000000v0000
00000000000000000000000000000000000000000000000000000000000000000000000000000000000000000000000000000000000000000000000000000000000000000000000000000000000000000000000000000000000000000000000440000000000f0000
0000000000000000000000000007eee0000000000000000000006666600000000000000000000000007eeeee0000000000eeeee00000000000000000000007eeee0000000000000000000000000000000000eeeeeeee0000700000000000000440000000000f0000
000000000000000000000000000000000000000000000000000000000000000000000000eeee0000000000000000000000000000000000000000000000000000000000000000000000000000000000000000000000000000000000000004000440000000000f0000
00000000000000000000000000000000000000000000000000000000000000000000000000000000000000000000000000000000000000000000000000000000000000000000000000000000000000000000000000000000000000000000000440000000000f0000
000000000000000000000004000000000000000000000000000000l0000000000000000000000000000000000000000000000000000000000000000000000000000q00000000000000000000000000000000000000000000000000000000000440000000000f0000
00000000000000e7e00000440004000000400000000000q000007666600000000000000e0000q00066660066600000000000000000q0000000000000000q0000000p0000000000000000000000000000060000000060000000000000004e000440000000000f0000
0000000000000000000004440000000000400000000000p00000000000000000000000000000p00000000000000000000000000000p0000000000000000p000q000p0000000000000000000000040000000000000000000000q000000000000440000000000f0000
0000000000000000000044440000000000440000000000p00000000000000000000000000000p00000000000000000000000000000p0000000000q00000p000p000p0000000000000000000000040000000000000000000000p000000000000440000000000f0000
0000m0000000000000044444000l0l00004400g0g00000p00000000000g0g0l00g0g0g000000p00000g0g0g000000000000000g000p0000000g00p000g0p000p000p00000000000000l0000000040000g0g000l0l000000000p00000l000000440000000000f0000
1111111111111111111111111111111111111111111111111111111111111111111111111111111111111111111111b000a11111111b000a11111111111111111111111111b000a111111111b00a1111111111111111111111111111111111111111111111111111
3333333333333333333333333333333333333333333333333333333333333333333333333333333333333333333333d000c33333333d000c33333333333333333333333333d000c333333333d00c3333333333333333333333333333333333333333333333333333
3333333333333333333333333333333333333333333333333333333333333333333333333333333333333333333333d000c33333333d000c33333333333333333333333333d000c333333333d00c3333333333333333333333333333333333333333333333333333
