0000000000000000000000000000000000000000000000000000000000000000000000000000000000000000000000000000000000000000000000000000000000000000000000000000000000000000000000000000000000000000000000000
0000000000000000000000000000000000000000000000000000000000000000000000000000000000000000000000000000000000000000000000000000000000000000000000000000000000000000000000000000000000000000000000000
0000000000000000000000000000000000000000000000000000000000000000000000000000000000000000000000000000000000000000000000000000000000000000000000000000000000000000000000000000000000000000000000000
0000000000000000000000000000000000000000000000000000000000000000000000000000000000000000000000000000000000000000000000000000000000000000000000000000000000000000000000000000000000000000000000000
0000000000000000000000000000000000000000000000000000000000000000000000000000000000000000000000000000000000000000000000000000000000000000000000000000000000000000000000000000000000000000000000000
000000000000000000000000000000000000000000000000000000000000000000000g000g0000000000000000000000000000000000000000000000000000000000000000000000000000000000000000000000000000000040000000v000000
000000000000000006000000000000000000000000000000000000000000000000000eeeeeeee000eee600000000000000700000000000eee00000e66e0000000000000000000000000000000000000000000000000000000440000000f000000
000000000000000000000000000000000000000000000000000000000000000000000000000000000000000000000000000000000000000000000000000000000000000000000000000000000000000000000000000000004440000000f000000
000000000000000000000000000000000000000000000000000000000000000000000000000000000000000000000000000000000000000000000000000000000000000000000000000000000000000000000000000000044440000000f000000
000000000000000000000000000000000000000000000000000000008000000000000000000000000000000000000000000000000000000000000000000000000000000000000000000000000000000000000000000000444440000000f000000
000000000006000e7e6e000000000000000000t00000000t000000000000000000e7e00000000000000e00000ee0000600600600000e0000000000ee00000040040000000000440040000000000000ee6e000000000004444440000000f000000
0000000000000000000000000000000t000000p00000000p000000000000000000000000000000000000000000000000000000000000000000000000000004400440000000044400440000000000000000000000000044444440000000f000000
0000000000000000000000t00000000p000000p00000000p000000000000000000000000000000000000000000000000000000000000000000000000000444400444400000444400444000000t000000000000000t0444444440000000f000000
00m000000000000g000000p00000000pg00000p00g00g00p0000000000000000000000000000000000000g0g0000000l0000000000000000g0g0g0g0000444400444400004444400444400000p000000000g0g000p4444444440000000f000000
11111111111111111111111111111111111111111111111111111111b00a111111111111111b0a111111111111111111111111111111111111111111111111111111111111111b00a111111111111111111111111111111111111111111111111
33333333333333333333333333333333333333333333333333333333d00c333333333333333d0c333333333333333333333333333333333333333333333333333333333333333d00c333333333333333333333333333333333333333333333333
