0000000000000000000000000000000000000000000000000000000000000000000000000000000000000000000000000000000000000000000000000000000000000000000000000000000000000000000000000000000000000000000000000
0000000000000000000000000000000000000000000000000000000000000000000000000000000000000000000000000000000000000000000000000000000000000000000000000000000000000000000000000000000000000000000000000
0000000000000000000000000000000000000000000000000000000000000000000000000000000000000000000000000000000000000000000000000000000000000000000000000000000000000000000000000000000000000000000000000
0000000000000000000000000000000000000000000000000000000000000000000000000000000000000000000000000000000000000000000000000000000000000000000000000000000000000000000000000000000000000000000000000
000000000000000000000000000000000000000000000000000000000000000000000g000g00000000000000000000000000000000000000000000000000000000000000000000000000000000000000000000000000000000400000000000000
0000000000000000060000000000000000000000000000000000000000000000000004444444400044460000000000000070000000000044400000466400000000000000000000000000000000000000000000000000000004400000000000000
0000000000000000000000000000000000000000000000000000000000000000000000000000000000000000000000000000000000000000000000000000000000000000000000000000000000000000000000000000000044400000000000000
0000000000000000000000000000000000000000000000000000000000000000000000000000000000000000000000000000000000000000000000000000000000000000000000000000000000000000000000000000000444400000000000000
0000000000000000000000000000000000000000000000000000000080000000000000000000000000000000000000000000000000000000000000000000000000000000000000000000000000000000000000000000004444400000000000000
00000000000600047464000000000000000000t00000000t0000000000000000004740000000000000040000044000060060060000040000000000440000004004000000000044000400000000000044640000000000044444400000000004000
0000000000000000000000000000000t000000p00000000p0000000000000000000000000000000000000000000000000000000000000000000000000000044004400000000444000440000000000000000000000000444444400000000044400
0000000000000000000000t00000000p000000p00000000p000000000000000000000000000000000000000000000000000000000000000000000000000044400444000000444400044400000t000000000000000t04444444400000000444440
00m000000000000g000000p00000000pg00000p00000gg0p0000000000000000000000000000000000000g0g0000000g0000000000000000g0g0gg00000444400444400004444400044440000p000000000g0g000p44444444400000004444444
11111111111111111111111111111111111111111111111111111111b00a111111111111111b0a111111111111111111111111111111111111111111111111111111111111111b00a111111111111111111111111111111111111111111111111
33333333333333333333333333333333333333333333333333333333d00c333333333333333d0c333333333333333333333333333333333333333333333333333333333333333d00c333333333333333333333333333333333333333333333333
33333333333333333333333333333333333333333333333333333333d00c333333333333333d0c333333333333333333333333333333333333333333333333333333333333333d00c333333333333333333333333333333333333333333333333
33333333333333333333333333333333333333333333333333333333d00c333333333333333d0c333333333333333333333333333333333333333333333333333333333333333d00c333333333333333333333333333333333333333333333333
