000000000000000000000000000000000000000000000000000000000000000000000000000
000011100000000000000000000000000000000000000000000000000000000000000000000
000000002000000000200002000000000200002000000000200002000000000200002000000
000000200000000000000200000000000000200000000000000200000000000000200000000
000111100000000000000000000000000000000001100000000000000000000000000000000
111111111000101111111111000111000001111000000111111110011111111110000111100
