000000000000000000000000000000000000000000000000000000000000000000000000000
000000000000000000000000000000000000000000000000000000000000000000000000000
000000000000000000000000000000000000000000000000000000000000000000000000000
000000000000000000000000000000000000000000000000000000000000000000000000000
000067600000000000000000000000000000000000000000000000000000000000000000000
000000000000000000000000000000000000000000000000000000000000000000000000000
00000m000000000000000000000000000000000067000000000000000000000000000000000
0000a1b00244420000000000000000000000000022000000000000000000000000000000000
0000c3d00000000000000000000000000000000000000000200002000000000200002000000
0000c3d0000000000t000000000000055000000055000000000200000000000000200000000
000a111b000g000abp0a1b00000000000000g00000000g0000g00000g000g0g000000000g00
11111111111111111111111b000a1b0000a111b0000a11111111b00a11111111b000a111111
33333333333333333333333d000c3d0000c333d0000c33333333d00c33333333d000c333333
33333333333333333333333d000c3d0000c333d0000c33333333d00c33333333d000c333333
33333333333333333333333d000c3d0000c333d0000c33333333d00c33333333d000c333333
33333333333333333333333d000c3d0000c333d0000c33333333d00c33333333d000c333333
