0000000000000000000000000000000000000000000000000000000000000000000000000000000000000000000000000000000000000000000000000000000000000000000000000000000000000000000000000000000000000000000000000
0000000000000000000000000000000000000000000000000000000000000000000000000000000000000000000000000000000000000000000000000000000000000000000000000000000000000000000000000000000000000000000000000
0000000000000000000000000000000000000000000000000000000000000000000000000000000000000000000000000000000000000000000000000000000000000000000000000000000000000000000000000000000000000000000000000
0000000000000000000000000000000000000000000000000000000000000000000000000000000000000000000000000000000000000000000000000000000000000000000000000000000000000000000000000000000000000000000000000
000000000000000000000000000000000000000000000000000000000000000000000g000g0000000000000000000000000000000000000000000000000000000000000000000000000000000000000000000000000000000040000000v000000
000000000000000006000000000000000000000000000000000000000000000000000eeeeeeee000eee600000000000000700000000000eee00000e66e0000000000000000000000000000000000000000000000000000000440000000f000000
000000000000000000000000000000000000000000000000000000000000000000000000000000000000000000000000000000000000000000000000000000000000000000000000000000000000000000000000000000004440000000f000000
000000000000000000000000000000000000000000000000000000000000000000000000000000000000000000000000000000000000000000000000000000000000000000000000000000000000000000000000000000044440000000f000000
00000000000000000000000000000000000000000000000000000008000000000000000000000000000000000000000000000000000000000000000000000000000000000000000000000000000000000000000000000444440000000f0000000
000000000006000e7e6e000000000000000000t00000000q000000000000000000e7e00000000000000e00000ee0000600600600000400000000004400000040040000000000440004000000000000ee6e000000000004444440000000f000000
0000000000000000000000000000000t000000p00000000p00000000000000000000000000000000000000000000000000000000i000000000000000000004400440000000044400044000000s00000000000000000044444440000000f000000
0000000000000000000000t00000000p000000p00000000p000000000000000000000000000000000000000000000000000000000000000000000000000044400444000000444400044400000t000000000000000t0444444440000000f000000
00m000000000000k000000p00000000p00g000p00g000g0p0000000000000000000000000000000000000g0g0000000g00000000h0000000g0g0g0g0000444400444400004444400044440000p000000000g0g000p4444444440000000f000000
11111111111111111111111111111111111111111111111111111111b00a111111111111111b0a111111111111111111111111111111111111111111111111111111111111111b00a111111111111111111111111111111111111111111111111
33333333333333333333333333333333333333333333333333333333d00c333333333333333d0c333333333333333333333333333333333333333333333333333333333333333d00c333333333333333333333333333333333333333333333333
33333333333333333333333333333333333333333333333333333333d00c333333333333333d0c333333333333333333333333333333333333333333333333333333333333333d00c333333333333333333333333333333333333333333333333
33333333333333333333333333333333333333333333333333333333d00c333333333333333d0c333333333333333333333333333333333333333333333333333333333333333d00c333333333333333333333333333333333333333333333333
