000000000000000
000000000000000
000200002000000
000000200000000
000000000000000
111111111010111
