000000000000000000000000000000000000000000000000000000000000000000000000000
000000000000000000000000000000000000000000000000000000000000000000000000000
000000000000000000000066006600000000000000000000000000000000000000000000000
00000m000000000000000000000000000000000000000000000000000000000000000000000
000011100000000000000005555000000000000000000000000000000000000000000000000
000000002000000000000000220000000000002000000000200002000000000200002000000
00000020000000000t000024444200000000000000000000000200000000000000200000000
00011110000000011p011100000000000000000000000000000000000000000000000000000
111111111000101111111111000111000011111000011111111110011111111110001111111
333333333000303333333333000333000033333000033333333330033333333330003333333
333333333000303333333333000333000033333000033333333330033333333330003333333
333333333000303333333333000333000033333000033333333330033333333330003333333
333333333000303333333333000333000033333000033333333330033333333330003333333
