000000000000000000000000000000000000000000000000000000000000000000000000000
000011100000000000000000000000000000000000000000000000000000000000000000000
000000002000000000000002222000000000002000000000200002000000000200002000000
000000200000000000000020000200000000000000000000000200000000000000200000000
000111100000000000000000000000000000000000000000000000000000000000000000000
111111111000101111111111000111000011111000011111111110011111111110001111100
333333333000303333333333000333000033333000033333333330033333333330003333300
333333333000303333333333000333000033333000033333333330033333333330003333300
333333333000303333333333000333000033333000033333333330033333333330003333300
333333333000303333333333000333000033333000033333333330033333333330003333300
333333333000303333333333000333000033333000033333333330033333333330003333300
